WWWWWWWWWWWWWWWWWWWW
W P .W....*...*Q...W
W..*.W.WWWWWWW.WW..W
W.O..W.W.....W.E...W
W.O....W.*.O.W.W...W
W......W.O.O...W...W
WWWWWW.W.WWWWWWW...W
W....O.............W
W.*.WWWWWWWWWWWW...W
W..................W
W..O...O...O...O...W
W..*...*...*...*...W
W..*...*...*...*...W
W..................W
WWWWWWWWWWWWWWWWWWWW
