WWWWWWWWWWWWWWWWWWWW
WWWWWWWWWWWWWWWWW**W
WP**EW**********WW*W
W**...Q.*WWWWWWWW*.W
W****W****......**.W
WWWWWWW...WWWWWWWW.W
W.****WWWW*****WW*.W
WW*.....***WW*****.W
WW*.W.**W******WWWWW
W**.W.**WW***WW.W**W
WWWWW.***WWWWW*****W
W**...*..W******WW*W
W*WWWWWWWWWWW***WW*W
W******************W
WWWWWWWWWWWWWWWWWWWW
