NORMAL:10
WWWWWWWWWWWWWWWWWWWW
W P.....*....O..*Q.W
W............*.....W
W..................W
W..........*.......W
W............O.....W
W..................W
W..........O.......W
W........*......*..W
W........O.....O...W
W..........*.......W
W..............*...W
W..*......*........W
W.....*.........E..W
WWWWWWWWWWWWWWWWWWWW
