NORMAL:11
WWWWWWWWWWWWWWWWWWWW
WP.O..O...O...O..Q.W
W......           XW
W. .....X    ......W
W  X   *...*...X..*W
W.O.O.O.O*O.O.O...EW
WWWWWM..WWWWMWWWWWWW
W...............O..W
W*...*...*...*..OO.W
W.O..O..O..O..O..O.W
W.........O........W
W....X..O...*..X.O.W
W..O..O..O..O......W
W*.....*.....*.. ..W
WWWWWWWWWWWWWWWWWWWW
